NO ./assets/north.xpm42
SO ./assets/south.xpm42
EA ./assets/east.xpm42
WE ./assets/west.xpm42

F 30,30,50
C 146,186,232

11111111111111111111111111111111
1000LL0LL0LL0L0L0L0L0L0LL0LL00C1
1000LL0LL0LL0LL0L0L0L0L0L0LL0001
1D1111111111111111111111111111K1
1C00L0LL0LL0LL0LL0L00L000LL0L001
1000L0LL0LL00LL0LLL00L000LL0L001
1K1111111111111111111111111111D1
100L0L0L000LL000LL0000LL00LL00C1
100L0L0L000LL000LL0000LL00LL0001
1D1111111111111111111111111111K1
1C00L0L00L000L0L000L0L000LL00001
1000L0L00L00L00L000L0L000LL00001
1K1111111111111111111111111111D1
100000LLL000000L00000L000L00L0W1
10LLL00000LLL00L00000L000L00L001
11111111111111111111111111111111
